                                                 
** ***** ****** ****************** 
** ***** ****** ****************** 
** *****        ****************** 
** ***** *******    ************** 
** ***** ********** ************** ******                                
** ***** ********** ************** *********** ************************  
**                                  ********** ************************* 
** **************** **************  ********** ************************* 
** **************** **************  ********** ************************* 
** ******* ******** **************  ********** ************************* 
** **$     ******** **************  ********** ************************* 
** *** ***          **************                         ************* 
** *** ************ **************  ***************** ****************** 
** *** ************ ********************************* ****************** 
** ***    ********* ********************************* ****************** 
** ***    *********                                                      
** ***    ********* ********************* *********** 
** ***    ********* ********************* *********** 
** ***    ********* ********************* *********** 
**                                                    
